to attach - прикреплять
to obtain   -  получать, потреблять
to tend to do something - иметь тенденцию делать чтото
отступать - to retreat 
tentacles    -    щупальцы
to grab - хватать, cхватывать
to cast doubt on - ставить под сомнение
decade    -  десятилетие 
to shed light - пролить свет 
overall - в общем и целом, общий, полный
fluid balance - баланс жидкости 
nutrients - питательные вещества 
official - должностное лицо
confusion - неразбериха 
to be aware - быть в курсе 
compelling - неотразимый, непреодолимый
to retain - удерживать, сохранять
kidneys - почки
to flush out - вымывать 
to put strain on - положить напряжение 
prolonged - длительный 
decline - снижение 
to contribute - делать вклад
to observe - наблюдать 
obesity - ожирение 
sophisticated - утонченный, тонкий
dwarf - карлики
celestial  - небесный 
to ignit - зажечь
a steady rate - устойчивый курс
emission - излучение
diminish - уменьшить
to observe - наблюдать
to be distinguished - быть выделенным
distinctive - отличительный, особый, характерный
to resemble - походить, иметь сходство
to contract - сокращаться 
predominantly - преимущественно
larynx - гортань
vocal folds - голосовые связки
to be think as beeing - считаться
to stretch - растягивать, тянуться
hence  - следовательно, с этих пор
tissue - ткань
pharynx - глотка
esophaugus - пищевод
underneath the lungs - под легкими 
rib cage - грудная клетка 
hard palate  - твердое небо
to trap - поглощать
puff of air - воздушный поток
to be enhanced - быть усиленным
to purse - морщиться, класть в кошелек
laryngeal - гортанный
extent - степень
to be hinghed - быть навесным
cartillage - хрящ
to abduct - похищать, насильно уводить
 to adduct - привести 
swallow - проглатывать 
intrinsic  - свойственный, присущий
bunch - связка, пучок, сбиваться в кучу
apart from - помимо
entire - все, полный 
lengtheners - удлинители
squeeze - выжимать, сдавливать
tighter   - тесный, тугой, сжатый
to resist - противостоять, сопротивляться
to enable - включить, дать возможность, разрешить
to inspect  - осматривать
during a merge - во время слияния
to track changes - отслеживать изменения
to hover - зависать, парить
to revert - возвращаться
to fetch - получать, приносить, доставать
to invoke - взывать, призывать
shortcut - кратчайшее расстояние, сокращенный
subsequently - впоследствии, позже
to merge - сливаться
to be rejected - быть отклоненным
counterpart - копия 
so far   - до сих пор, пока

